Espanol
LanguageSelectionButton:	Aceptar
TitleButton:	Empezar
RestartButton:	Volver
CreditsButton:	Creditos
GameButton:	Jugar
ExitButton:	Salir
SingleButton:	Jugar Solo
MultiButton:	En Linea
Tutorial:	Tutorial
FastMatchButton:	Buscar
CreateLobbyButton:	Crear
JoinLobbyButton:	Unirse
InputCodeIF:	Codigo ...
SubmitCodeButton:	Unirse
ConfigButton:	Ajustes
NombreAvast:	AVAST
DescripcionAvast:	Elimina los virus de la RAM. Carta de antivirus.
NombreCPU:	CPU
DescripcionCPU:	Unidad central de procesamiento. Carta de componente.
NombreError:	ERROR
DescripcionError:	Envias un error al siguiente oponente. No juega su turno. Carta de ataque.
NombreEscudo:	ESCUDO
DescripcionEscudo:	Evitas que salga un error en tu dispositivo. Bloqueas el ataque. Carta de defensa.
NombreGPU:	GPU
DescripcionGPU:	Tarjeta gráfica. Carta de componente.
NombreKaspersky:	KASPERSKY
DescripcionKaspersky:	Elimina los virus encontrados en el SSD. Carta de antivirus.
NombreLinux:	LINUX
DescripcionLinux:	Instalas Linux a un oponente. Eliminas todos sus antivirus. Carta de ataque.
NombreMcAfee:	MCAFEE
DescripcionMcAfee:	Elimina los virus encontrados en la GPU. Carta de antivirus.
NombreMinero:	MINERO
DescripcionMinero:	Minas criptomonedas. Afecta a la GPU. Carta de virus.
NombrePanda:	PANDA
DescripcionPanda:	Elimina los virus encontrados en la CPU. Carta de antivirus.
NombreRAM:	RAM
DescripcionRAM:	Memoria de acceso aleatorio. Carta de componente.
NombreRansomware:	RANSOMWARE
DescripcionRansomware:	Cifra los archivos del ordenador. Afecta al SSD. Carta de virus.
NombreSpyware:	SPYWARE
DescripcionSpyware:	Espia el dispositivo infectado. Afecta a la CPU. Carta de virus.
NombreSSD:	SSD
DescripcionSSD:	Disco duro del sistema. Carta de componente.
NombreTroyano:	TROYANO
DescripcionTroyano:	Ejecuta programas en segundo plano. Afecta a la RAM. Carta de virus.
NombreWindows:	WINDOWS
DescripcionWindows:	Instalas Windows durante la instalación de Linux. Bloqueas el ataque. Carta de defensa.
tutorialBUT:	Siguiente
titulo1Tutorial:	Cartas de componente
texto1Tutorial:	Los componentes son los objetos que debes proteger e infectar a otros jugadores para ganar la partida.
titulo2Tutorial:	Cartas de antivirus
texto2Tutorial:	Los antivirus pueden desinfectar tus componentes si tienen virus. Si no tienen virus, se usan como escudo.
titulo3Tutorial:	Cartas de virus
texto3Tutorial:	Los virus pueden infectar tus componentes. Si un componente tiene un antivirus, lo elimina y lo deja vulnerable.
titulo4Tutorial:	Cartas de ataque
texto4Tutorial:	Las cartas de ataque se usan directamente sobre los jugadores rivales, afectando a sus componentes o a su tiempo de juego.
titulo5Tutorial:	Cartas de defensa
texto5Tutorial:	Las cartas de defensa sirven para protegerse de los ataques. Deben usarse justo despuÃ©s de ser atacado.
discardBUT:	Descartar
throwBUT:	Tirar
PlayerTurn:	Turno de Jugador 2
victoryButton:	Victoria
victoryText:	Clic aqui para pantalla de victoria
defeatButton:	Derrota
defeatText:	Clic aqui para pantalla de derrota
vicScreenText:	Has ganado!
vicScreenButton:	Continuar
defScreenText:	Has perdido!
defScreenButton:	Continuar
MasterSound:	Volumen General
MusicSound:	Musica
EffectsSound:	Efectos
ChatSound:	Chat de Voz
WindowMode:	Modo de Ventana
WindowResolution:	Resolucion
WRWidthIF:	Ancho
WRHeightIF:	Alto
SoundAndWindowButton:	Sonido Y Pantalla
ConfigGameButton:	Juego
AccesibilityButton:	Accesibilidad
GoBackButton:	Atras
DiscardChangesButton:	Desechar Cambios
ApplyChangesButton:	Aplicar Cambios
WindowModeDD_0:	Pantalla Completa
WindowModeDD_1:	En Ventana
Graphics:	Graficos
Effects:	Efectos
Language:	Idioma
GraphicDD_0:	Muy Bajos
GraphicDD_1:	Bajos
GraphicDD_2:	Medios
GraphicDD_3:	Altos
GraphicDD_4:	Muy Altos
GraphicDD_5:	Extremo
Daltonism:	Modo Daltonico
DaltonismDD_0:	No
DaltonismDD_1:	Protanipia
DaltonismDD_2:	Deuteranopia
DaltonismDD_3:	Tritanopia
TextSize:	Text Size
TextSizeDD_0:	Small
TextSizeDD_1:	Medium
TextSizeDD_2:	Large